XXXXXXXXXXXXXXXXXXXX
XMMMMFDDDDDDFMMCMMMX
XMM=FFDDDDDDFFMMMMMX
XMMFFDDDDDDDDF==MMMX
XMFFDFFFFFFFFFFFFMCX
XFFDDFMMMMMMMMFFFMMX
XDDDFFMMMMMMMMFFFFMX
XDDDFMMCTMMTTMMFDFFX
XDDDFMMTTTTTTMMFDDDX
XDDDFMM=TTTT=MMFDDDX
XDDDFMM=TTST=MMFDDDX
XDDDFMMTTTTTTMMFDDDX
XDDDFMMTTMMTCMMFDDDX
XDDDFFMMMMMMMMFFDDDX
XFFFEFFFFFFFFFFDDMMX
XMMFFDDDDDDDDDDDMMMX
XMMMFFFFFFFFFFFMMMMX
XMMMM=FFFFFFFFFMM=TX
XMMMMMMMMMMMMMMMMTTX
XXXXXXXXXXXXXXXXXXXX